---------------------------------------------------------------------------------------------------------------------------------------------------------------------------------------------------------------------------------------------------------------
--------------------------------------------------------------------------------------O-O------------O-O-------------------------------------------------------------------------------------------------------------------------------------------------------
---0-------------------0----------------------------0----------------0-------------------------------------------------------------------------------------------------------------------------------------------------------------0---------------------------
----------0--------------------------0-------------------0--------------------0-------------0--------------0---------0------------------------0---------------------------------0-------------------------0----------------------------------------------------
---------------------------------------------------------------------------------------------------------------------------------------------------------------------------------------------------------------------------------------------------------------
--------------------------------------------------------------------------------------------------------------------------------------------------------------------------------------------------------------------QQ---QQ------------------------------------
-----------------------------------------------------------------------------------BBBBB------BBBB---------------------------------------BBB-------BBBB------------------------------------------------------------QQQ---QQQ-----------------------------------
------------------------------------------------------------------------------------------------------------------------------------------------------------------------------------------------------------------QQQQ---QQQQ----------------------------------
-------------BBB-------------------------------------------------------------------------------------------------------------------------------------------------------------------------------------------------QQQQQ---QQQQQ------------------324------------
--------------------------------------------------------------------------------------------------------------------SP------------------------------------------------------------------BBB---------------------QQQQQQ---QQQQQQ------------------b-------------
---------------------------BqB--------BB----------------------------------------------------------------------------LR-----------------------------------------------------------------------------------------QQQQQQQ---QQQQQQQ---------------12221-----------
--------------------------------------------------------------------------------------------------------------------LR-------------------------SP-------------------------------------------------------------QQQQQQQQ---QQQQQQQQ--------------bbgbb-----------
-----t--------------t-------------------------------------t----------------------t----------------------------------LR------------t------------LR------------------------------------------------------------QQQQQQQQQ---QQQQQQQQQ-------------bb-bb-----------
GGGGGGGGGGGGGGGGGGGGGGGGGGGGGGGGGGGGGGGGG---GGGGGGGGGGGGGGGGGGGGGGGGG--GGGGGGGGGGGGGGGGG----GGGGGGGGGGGGGGGGGGGGGGGGGGGGGGGGGGGGGGGGGGGGGGGGGGGGGGGGGGGGGGGGG-----GGGGGGGGGGGGGGGGGGGGGGGGGGGGGGGGGGGGGGGGGGGGGGGGGGGGGGGGGGGGGGGGGGGGGGGGGGGGGGGGGGGGGGGGGGGGG
GGGGGGGGGGGGGGGGGGGGGGGGGGGGGGGGGGGGGGGGG---GGGGGGGGGGGGGGGGGGGGGGGGG--GGGGGGGGGGGGGGGGG----GGGGGGGGGGGGGGGGGGGGGGGGGGGGGGGGGGGGGGGGGGGGGGGGGGGGGGGGGGGGGGGGG-----GGGGGGGGGGGGGGGGGGGGGGGGGGGGGGGGGGGGGGGGGGGGGGGGGGGGGGGGGGGGGGGGGGGGGGGGGGGGGGGGGGGGGGGGGGGGG
GGGGGGGGGGGGGGGGGGGGGGGGGGGGGGGGGGGGGGGGG---GGGGGGGGGGGGGGGGGGGGGGGGG--GGGGGGGGGGGGGGGGG----GGGGGGGGGGGGGGGGGGGGGGGGGGGGGGGGGGGGGGGGGGGGGGGGGGGGGGGGGGGGGGGGG-----GGGGGGGGGGGGGGGGGGGGGGGGGGGGGGGGGGGGGGGGGGGGGGGGGGGGGGGGGGGGGGGGGGGGGGGGGGGGGGGGGGGGGGGGGGGGG